1111111111111
1E0000P000011
1000000000001
1111111111111
1111111111111
1111111111111
1111111111111
1111111111111
