111111111111111111111111111
1P0000000000000000000000001
100000000001110001110111001
100000000111100001100111001
100000011110000001000111001
100001111000000000011100001
100111100000000001110001001
100111111111110001110011001
100111111111110001110111001
100000000001110000000000001
100000000001110000000000001
100000000000000000000000001
111111111111111111111111111
