111111111111111111111111111
1p0000000000000000000000001
100000000001110001110111001
100000000111000001100111001
100000011100000001000111001
100001110000000000011100001
100111000000000001110001001
100111111111110001110011001
100111111111110001110111001
100000000001110000000000001
100000000001110000000000001
100000000000000000000000001
111111111111111111111111111