11111111111111111111
1P100001000000100001
10000001001100100001
10000111001101100101
10100001001101000101
1000000c011000001111
11111111111111111111
